#############
#..##EE##...#
#...........#
#M########..#
#PS.........#
#############